.........R>X
...R>D...^..
...^.|...^..
.R>U.r>D.^..
SU.....|.^..
.......r>U..
