.........r>X
...r>*...^..
...^.|...^..
.r>+.L>*.^..
S+.....|.^..
.......L>+..
